11 17 90
#################
#a***##********1#
####****#*#####*#
#*$#*####*#*D$#!#
#D##****#*#^###*#
#****##*#*#*###*#
#*##*##2********#
#*****##*####*#*#
#*###*********#*#
#3***%###~###4*%#
#################