12 15 80
###############
#1*****%*****2#
#!#####*#####*#
#**********~**#
#*###*###*###*#
#*#$D**4**D$#*#
#*#####*#####*#
#*#^********#*#
#***#*#*#%#***#
#*#####*#####*#
#a***********3#
###############
