16 16 120
################
#a#$D****##1####
#*###*##******!#
#*****##*##*#D##
#*##*#****#%#*$#
#*##*##*###*####
#*************##
#*#%##*####*#**#
#*###2******##*#
#*#$#*#*###****#
#*#D#*#**~**##*#
#*#*#*#*######*#
#*******#%*****#
#*#####*######*#
#3*****^******4#
################